NO ./doom.xpm
SO ./doom2.xpm
WE ./doom3.xpm
EA ./doom4.xpm

F 220,100,0
C 225,30,0

111111111111111
100000001000001
1000N0100010101
110110101111101
100000100010001
101110101000101
101001000100101
101000110100011
100010000001001
111111111111111
